#domain
hospital
#levelname
MATrueGlue
#colors
red: 0, A, B
#initial
++++++++++++++++++++++
+       +         0  +
+       +         +  +
+       +         +  +
+                 +  +
+       +         + A+
+       +     +   +  +
+       +     +   +  +
+             +   +  +
+B            +   +  +
+       +     +   +  +
+      +++++  +   +  +
+                 +  +
+      ++++++++++    +
+                    +
++++++++++++++++++++++
#goal
++++++++++++++++++++++
+       +            +
+       +         +  +
+       +         +  +
+                 ++B+
+       +         ++A+
+       +     +   + ++
+       +     +   +  +
+             +   +  +
+             +   +  +
+       +     +   +  +
+      +++++  +   +  +
+                 +  +
+      ++++++++++    +
+                    +
++++++++++++++++++++++
#end
